11111111111111111
10010100011000E01
1001C000000011011
11000000010000011
10110110010011001
10000000000111011
10011101000000011
11001101110011011
100000000010100C1
11111100000000011
10P0C001001000001
11111111111111111
